..........
--.--..--.
-.....-..-
....-.....
...--.....
.-....---.
..--.....-
..-..-....
--.-..--.-
.-..-.-.-.
