
 - - - - -
-- -  -  -
- - - -  -
-  --  - -
 - -  ---
 ----  - -
- -  - -
-- -  -- -
 -  - - -
